155
22222222222222222222222222222222222222222222222222222222222222222222200000000000000000222222222222222222222222222222222222222222222222222222222222222222222
22222222222222222222222222222222222222222222222222222222222222000000000111010111111100000000022222222222222222222222222222222222222222222222222222222222222
22222222222222222222222222222222222222222222222222222222220000000000000101010000000100000000000002222222222222222222222222222222222222222222222222222222222
22222222222222222222222222222222222222222222222222222200000111111101111101111101011101111111111100000222222222222222222222222222222222222222222222222222222
22222222222222222222222222222222222222222222222222200000000101000001000100000101010001000000010000000000222222222222222222222222222222222222222222222222222
22222222222222222222222222222222222222222222222220000111111101011111110101110101010111111101110111111100002222222222222222222222222222222222222222222222222
22222222222222222222222222222222222222222222220000000000010001010000000101010101010000000101000100000100000002222222222222222222222222222222222222222222222
22222222222222222222222222222222222222222222000111111111011101011101111101011101011101111101110101110111111100022222222222222222222222222222222222222222222
22222222222222222222222222222222222222222200000000010001000001000101000001000001000100000000010101010000000100000222222222222222222222222222222222222222222
22222222222222222222222222222222222222220001111111110101111101011101110111011111110101111111010101011111010111110002222222222222222222222222222222222222222
22222222222222222222222222222222222222200001010000000100000101010000010001000000010101000001010100010001010000010000222222222222222222222222222222222222222
22222222222222222222222222222222222220000101011101011101111111010111011101111111110111011111011111110111110111111100002222222222222222222222222222222222222
22222222222222222222222222222222222000000101000101010101000000010001000101000000000000010000000000000000010100000100000022222222222222222222222222222222222
22222222222222222222222222222222220001111101010101110101011111111111110101011101111101110111111101111111010111110101110002222222222222222222222222222222222
22222222222222222222222222222222000000000101010100000101010000000000010100010101000101000100000101000001000000010101010000022222222222222222222222222222222
22222222222222222222222222222220011111111101010111110101010111110111010101110101110111011101110101011111011101110111010111002222222222222222222222222222222
22222222222222222222222222222200010001000001010000010101010100010101000101000100010000010001000101010000010101000000010100000222222222222222222222222222222
22222222222222222222222222220001110111011101011111010111010111010101111101110111110111110111011101011101110111011101110111110002222222222222222222222222222
22222222222222222222222222200000010100010101010001010000010101010100000000010000000001000001010001000100010000010101000000010000222222222222222222222222222
22222222222222222222222222000111010111010111010111010111110101010111111111110111011111011111011111010111010111110101011111110100022222222222222222222222222
22222222222222222222222220000101000001010000010100010100000101000000000000000100010100010100000000010001010100010101010000010100002222222222222222222222222
22222222222222222222222200011101011111010111010111010111010101111101111111011111010111010111111111011111010101110101010111010111000222222222222222222222222
22222222222222222222222000010001010000010101000001010001010100010100010001000001010001010000000100010000010001000101010100010100000022222222222222222222222
22222222222222222222220001110111010111010101011111011111010111010111110101111101110111010111110111110111110111010101110101110111110002222222222222222222222
22222222222222222222200001000001010101010101010001000000010001010000000100000101000100010000010000000001000100010100000101000101000000222222222222222222222
22222222222222222222000111111101110101110101110111011111110111011101111111011101011101110111011111111111011111011111110101110101111100022222222222222222222
22222222222222222220000100000101000100000100000100000101010100000101000100010000010001000101000001000000010001000000010100010100010000002222222222222222222
22222222222222222200011111110101011101111101110111110101010111110101110111110111110111111101011111011101110101111111010111010111011111000222222222222222222
22222222222222222000000000000101010001010001010000010001010001000100010000000100000000000001010000000101000100000101010001010000000001000022222222222222222
22222222222222222001111111111101011101011111011101111111010111011101110111111111111101111101011111011101110101110101011101011111111101110022222222222222222
22222222222222220001000000000100000101000000000100000000000100010001000001000000000101000101000001010000010101010001000101000000000101010002222222222222222
22222222222222200111011111010101111101011111010111110111111111010101011101011111110101011101011111010111110101011101010111111101110111010100222222222222222
22222222222222000001010001010101000001010001010000010100000000010101010100010000010101000001010000010100000101000101010000000100010000010100022222222222222
22222222222222011111010111110101111101110101011111010101110111110101010111110111011101111101010111010111011101011111010111110111011111010111022222222222222
22222222222220010100010100000100000100000101010001010101010100000101010000000001000001000101010101010001000101000000010101000001010001010101002222222222222
22222222222200010101110111011101110111110101010101011101010111110111110111111111110101010111011101011111111101110111110101110111010111011101000222222222222
22222222222200000101010000010000010000010101010101000001010000010000000001000000010101010000010001000000000100010100000100010100010101000001000222222222222
22222222222001111101011101110111110111010101010111011111011111011101111111011111110101011111111101110111011111010111110101011111010101011101010022222222222
22222222222001000000000101000001000101010101010000010100000001000101000000000000010101000000000000010101000001010000010101000001000100010101010022222222222
22222222220001011111111101111111011101110101010111110111111101110101110111110111011101110111111111010101111101010111110111011101111101110101010002222222222
22222222200001010100000100000100010000000101010100000000000101000101010100010101000000010100000001010100000100010100000001010100000101000101010000222222222
22222222200111010101110101110101110111110101011111111101110101011101011101011101111111010111011111011101110101110111111111010111011101110111011100222222222
22222222000001000101010001010101000001010101000000000001010101010001000001000000000101010001010000010001010101000100000000010001010000010000000100022222222
22222222011101110111011111011101011111010111111111110111011101011101011111110111110101011111011111010111011101110101110111110111011111011101111111022222222
22222220010100010000010000000001010100010000000000010100010000000101000101010100010100000000000001000100000000010001010100000100000100000100010001002222222
22222220010111011111011111111101010101011101111111110101110111110101110101010101110111111111111101110101110111011111010111110101111101111101110101002222222
22222200010001000101000000000001000101000101000000000101000100010100010001010001000000010000000000010101010101000000010000010100000001000001000101000222222
22222201110101110101011111011111011101011101110111111101011101011101010111011101011111110111111111010111010101111111011101110111111101110111011101010222222
22222201000100010001010001010000010001010000010100000000010001000001010100000101010000000100000100010000010100000001010001000000000100010100000101010222222
22222001011111111111011101011111110101110111111101111111110111111111111101111111011111111111110111111111110111110111110111011111111101011101111101110022222
22222001000100000000000101000000000101000000000101000000000000000000000000000000000000000000000000000000000000010000000100010000000101000001010000010022222
22220001110101110111111101111101111111011111010101022222222222222222222222222222222222222222222222222201111111011101111101011111110111110111011111110002222
22220000010100010100000000010101000000010001010101022222222222222222222222222222222222222222222222222201000101000101000001000000010100000100000000000002222
22220111110101110111011101110101111111010101011101022222222222222222222222222222222222222222222222222201011101111101110111110111010101111101111101111102222
22200101000101010001000101010000000001010101000001022222222222222222222222222222222222222222222222222201010000000100010100000101010101000000010001000100222
22200101010111010111011101010111111111010101110111022222222222222222222222222222222222222222222222222201011111011101011101110101110101011111010111010100222
22200101010000010100010101000100000000010100010100022222222222222222222222222222222222222222222222222201000001000101000101010100000101010101010100010100222
22200101011101110111010101111101110111110111010111022222222222222222222222222222222222222222222222222201011101110111011101010111110101010101110101110100222
22000001010101000001010100000001010100000101010001022222222222222222222222222222222222222222222222222200010100010000010001010000010101000100010101010100022
22011111010111111101110101111101011101110101011101022222222222222222222222222222222222222222222222222201110111010111110111011101110101011101110111010111022
22010000000000010000000101000101000001010001000101022222222222222222222222222222222222222222222222222201000001010100000100000101000101010001000100000001022
22010111111101110111110101010111011111011111011101022222222222222222222222222222222222222222222222222201110111110111011101111111011101010111011101111111022
20010100000100000100010101010000010100000000010001022222222222222222222222222222222222222222222222222201010000010001010100000000010001010000010001000001002
20010101110111111111010101011111110101111101110111022222222222222222222222222222222222222222222222222201011111011101010101110111110111010111011101110111002
20010100010000000000010101010100000101000101000101022222222222222222222222222222222222222222222222222201000001000101010101010001000100010101000100010100002
20011101110111110111010101010101110101110111011101022222222222222222222222222222222222222222222222222201011101110101010101011101011101011101111111010111002
20010001010101000101010101000101000100010000010001022222222222222222222222222222222222222222222222222201010100010001010001000101010001010000000000010001002
20011101011101011101110111011101111101110101111101022222222222222222222222222222222222222222222222222201010111011101011101010101010111110111110111010101002
20000101000000010000010000010000000101000101000101022222222222222222222222222222222222222222222222222201010001000101000101010101010000000100010101010101002
00011111011111011111010111111111110101011111011101022222222222222222222222222222222222222222222222222201011101110111110101010101011111011101111101110111000
00000001010001000001010100000000010001000001010001022222222222222222222222222222222222222222222222222201010100010000000101010100000001010000000000000100000
01110111010101110111010111110111110111011101011101022222222222222222222222222222222222222222222222222201010101111101111101010101110111010111110111011101110
01010000010100010101000001000100000100010100010100022222222222222222222222222222222222222222222222222201000100000101000101010101010100010100010101010000010
01011111110111111101011111011101111101110111010111022222222222222222222222222222222222222222222222222201110111110101010101010101011101110111010101011101110
01000000000100000000010000010001000001000001010001022222222222222222222222222222222222222222222222222200010000010001010101010101000000010001010001000101010
01111101110101111101110111010111011111011101010111022222222222222222222222222222222222222222222222222201010111010111011101110111011111011111011101111101010
01000101010101000101000100010100000100010001010101022222222222222222222222222222222222222222222222222201010101010100000000010000010001010000000101000001000
01110101010101110111011111011101111101110111010101022222222222222222222222222222222222222222222222222201011101010111111111010111110101011111011101011101110
00000101010000010000000001000001000001010100010101022222222222222222222222222222222222222222222222222201000001010000000001010101000101000100010001010100010
01111101010111110111011111011111011111010111010101022222222222222222222222222222222222222222222222222201111101011101111101110101011101010101110101010111010
01000001010100000101010001010001000000010001010100022222222222222222222222222222222222222222222222222201000101010001010000000001000101010101000101010001010
01111111011101111101010101011101011111011111010111022222222222222222222222222222222222222222222222222201011101011111011111110111011101011101011101011101010
01000000000000010001010101000101010001000100000101022222222222222222222222222222222222222222222222222201010001010000000100010100010001000001010101010101010
01111101110111110111110101011101011101110111110101022222222222222222222222222222222222222222222222222201011111011101110111010101111101110111010101010101110
00000101000101000000000101000001000100010000010001022222222222222222222222222222222222222222222222222201000000000001010001010101000100010100010101000100000
00010101111101011111011111011101111101110111011101022222222222222222222222222222222222222222222222222201011111111101011111011101110111010101110101110111000
20010100000101010001010000010100000101000101000101022222222222222222222222222222222222222222222222222201000100010101010000000100000001010101000100010101002
20010111110101111101010101110111110101010101110101022222222222222222222222222222222222222222222222222201110101110101010111011101111101111101011111010101002
20010000010100000001010101010000010101010101000101022222222222222222222222222222222222222222222222222200010101000101000101010001000100000001010000010001002
20011111010111011111010111011101110101011101110101022222222222222222222222222222222222222222222222222201010101010101111101011101110111011111010111011111002
20010100010000010000010000000101000001010000010101022222222222222222222222222222222222222222222222222201010001010101000001000101000001010000000101000001002
20010111011111110101110111110101011111011111010111022222222222222222222222222222222222222222222222222201011111011101110111011101011111010111111101110111002
20010001000000000101000100010101010000000000010000022222222222222222222222222222222222222222222222222201000000010000010100000001010000010100000000010100002
22011101111111011101011101010101110111111101111111022222222222222222222222222222222222222222222222222201111111110111110111111111010111110101111101110101022
22000100010001000101010001010100000000010101000001022222222222222222222222222222222222222222222222222201000000000001000000000000010100010100000101000101022
22011111010111111101110111010101011111110111011101022222222222222222222222222222222222222222222222222201111101111101011101111111010111010111110101111111022
22000000010000000100000100010101010100000100000101022222222222222222222222222222222222222222222222222200000100010101010100010000010001000000010100000000022
22200111110111110111111101110101110111110101110111022222222222222222222222222222222222222222222222222201110111010101110111110111010111011111110111111100222
22200100000100010001000001000100000100010001010001022222222222222222222222222222222222222222222222222201000001010100000001000101010100010000000100010100222
22200111110111011101011101011111110111011111011101022222222222222222222222222222222222222222222222222201011101110101011111011101110101110111111111010100222
22200100010001000100010101000000010000010000000101022222222222222222222222222222222222222222222222222201010100000101010000010000000101000000000001010100222
22220101110101010101110101011111110111010111111101022222222222222222222222222222222222222222222222222201110111110101110111110111111101011111111101010102222
22220001010101010101000101010000000101000100000001000000000000000000000000000000000000000000000000000000000000010100000100000100000101010000000101010002222
22220001011101010111110101110111111101110111110111111111011101111111111111011101110101111111011111111111110111010101110101110101111101110111110101010002222
22222001000001010000000100000100010000010100010000000001000101000000010001010101010101010001010001000000010101010101010101000101000100000100000100010022222
22222001011101011111011101111111011101110111011111110111111101011111011101110111010111010101010111011111110101110111010101011101110111111101110111010022222
22222201010101000001010100000100000101000000000000010000000101000001000100000000010100010101000100010000000100010000010101010000010000010001010001010222222
22222201110111011111010111110101111101111111111111011111110101111111110111111111010101110111011101011101111111010111010101010111010111010111011111110222222
22222200010000010000010000010001000100000000000001000000010100000000010000000001010001000100010001000100000101010101010101010001010101000100000000000222222
22222220011111011101110101110111011101111101111111111111110101111111011111110111010111010101110111110101110101011101011101011111011101110111110111002222222
22222220000001010101000101000100010001000100000000000000000101000001000001000100010100010101000001010101010101000000000001000001000000010000010101002222222
22222222011111010101110101111101110111010111011111110111111101111101111101011101111101111101110111010111010101111101111111011101110111010111010101022222222
22222222000100000100010101000000000100010001010000010000000000000100010001010100000000000100010100000000010000000101010001010000010101010101010100022222222
22222222200111111101010111011101111101111101110101110111111101111101010111010101111111110111010111011111011111110101011101110111011101010101011100222222222
22222222200000000101010000010101000001000100000101000100000101000001010100010001000000010001010101010001000000010101000100000101000001010101010000222222222
22222222220001110111011111010111011101110101111101110101110111010111011101110111011111011101110101010111110111011101110111011101011111011101110002222222222
22222222222001010001000001010000010101010100000100010100010000010101000001000100010001000100000101010100010101000100010001010001010000000000000022222222222
22222222222001011111011101110111110101010111111111010111011101110101111101111101110101010101110101110111010101111111010111011101010111111111110022222222222
22222222222200010000000100000000010001010001000001010001010001010101000100000001000101010101010001000001000100000000010100000101010101000001000222222222222
22222222222200011111111101111111011111010111011101011101011101010101011111110111011111110111011101011111011111011111110111111101110101011111000222222222222
22222222222220000000000100000101000100010100010100010101000101010101000000000101000000000000000100010000010000010000000000000000000001010000002222222222222
22222222222222011111110101111101110101110101010111110101011101011101111111111101111111111111011101110111110111110111110111111111110111011111022222222222222
22222222222222000100000101000000010001000101010000010001010001000000000000000000000000000100010001000100000100000100010100010000010100000100022222222222222
22222222222222200111011101110111010111011111010111110111011101110111110111110111110111110111010111111101110101110101011101110111010111011100222222222222222
22222222222222220001010000010101010100010000010100000100000100010100010101010100010000010001010000000001010101010101000001000101010101010002222222222222222
22222222222222222001111101110101010111010111110101110101110111011101010101010111010111010111011111111111010111010101011111011101010101010022222222222222222
22222222222222222000000101000101010001010100000101010101010101000001010001010001010101010101000000000000010000010101010001010001010001000022222222222222222
22222222222222222200011111011101011101010101110111010111010101111111011101011111011101110101110111011111011101110111011101011101010111000222222222222222222
22222222222222222220000000000001000101000101000000010000010001000001000101000000000000010100000101010101000101000100000100000101010100002222222222222222222
22222222222222222222000111111101110101110101111101110111011101011111011101111111011101110101110101110101110101110101110111111101011100022222222222222222222
22222222222222222222200001000100010101010100010001000100000101010000010001000001010100010101010100000100000100010101010000010001010000222222222222222222222
22222222222222222222220001110111110101010111011101110101111101010111010111111101110111010101010101110111011111010101011111010111010002222222222222222222222
22222222222222222222222000010000010101010001000100010101000001010101010100000000000101010101010101010001010001010101000001010101000022222222222222222222222
22222222222222222222222200011101110101011101110111010101110111010101110101110111110101010111010101010111011101010101110111010101000222222222222222222222222
22222222222222222222222220000100010100000100010001010100010100010100000101010100010101010000010101000100000100010100010100000100002222222222222222222222222
22222222222222222222222222000111010101111111011101011101110111010101111101011101010101010111011101011101110111110101110101111100022222222222222222222222222
22222222222222222222222222200001000101000000000101000101000001010100000001000001010001010101000001010001010000000101000100010000222222222222222222222222222
22222222222222222222222222220001110101111101110101111101011111010111011111011111011111011101011111011111010111111101110111110002222222222222222222222222222
22222222222222222222222222222200010100000101010101000001000100000001010000010000000000000001010101000000010100000000010001000222222222222222222222222222222
22222222222222222222222222222220011111110111010101111101110101111111010111110111111111111101010101111111011111111101110111002222222222222222222222222222222
22222222222222222222222222222222000000010000010100000100010101000001010001000100000100000001000100000001000000010001010000022222222222222222222222222222222
22222222222222222222222222222222220001111101110101111111010111011101011101011101110111111101011101110111011101110111010002222222222222222222222222222222222
22222222222222222222222222222222222000000101010101000001010100010101000101010001010000010101010001000100010101000100000022222222222222222222222222222222222
22222222222222222222222222222222222220000111010101011101010101110101111101110111011111010111011101111101110101011100002222222222222222222222222222222222222
22222222222222222222222222222222222222200000010100010100010101000100010000000100000001000001000101000001000100010000222222222222222222222222222222222222222
22222222222222222222222222222222222222220001110111110111110101011101110111111101111101011101111101110111011111110002222222222222222222222222222222222222222
22222222222222222222222222222222222222222200000100000000000101000100000100000001000101010100010000000100010000000222222222222222222222222222222222222222222
22222222222222222222222222222222222222222222000111111101111101110111110101111101010101010111010111111101111100022222222222222222222222222222222222222222222
22222222222222222222222222222222222222222222220000000100000000010000010101000101010101010001000100000100000002222222222222222222222222222222222222222222222
22222222222222222222222222222222222222222222222220000111111111110101110111011101011101010101110101111100002222222222222222222222222222222222222222222222222
22222222222222222222222222222222222222222222222222200000000000000101000000010001000001010100010100000000222222222222222222222222222222222222222222222222222
22222222222222222222222222222222222222222222222222222200000111111111111111010111110111110111111100000222222222222222222222222222222222222222222222222222222
22222222222222222222222222222222222222222222222222222222220000000000000001010100010100000000000002222222222222222222222222222222222222222222222222222222222
22222222222222222222222222222222222222222222222222222222222222000000000111110111011100000000022222222222222222222222222222222222222222222222222222222222222
22222222222222222222222222222222222222222222222222222222222222222222200000000000000000222222222222222222222222222222222222222222222222222222222222222222222
