155
22222222222222222222222222222222222222222222222222222222222222222222200000000000000000222222222222222222222222222222222222222222222222222222222222222222222
22222222222222222222222222222222222222222222222222222222222222000000000111110101110100000000022222222222222222222222222222222222222222222222222222222222222
22222222222222222222222222222222222222222222222222222222220000000000000100010101010100000000000002222222222222222222222222222222222222222222222222222222222
22222222222222222222222222222222222222222222222222222200000111011111011111010101011111011111111100000222222222222222222222222222222222222222222222222222222
22222222222222222222222222222222222222222222222222200000000100010001010000010101000001010001000000000000222222222222222222222222222222222222222222222222222
22222222222222222222222222222222222222222222222220000111011101110111010111110111011101010101111111111100002222222222222222222222222222222222222222222222222
22222222222222222222222222222222222222222222220000000101010101000100010100010000010101010100000001010000000002222222222222222222222222222222222222222222222
22222222222222222222222222222222222222222222000111111101110101110111010111011101110101011111010111010111111100022222222222222222222222222222222222222222222
22222222222222222222222222222222222222222200000100000001000001000001010001000001000101000001010100000101000100000222222222222222222222222222222222222222222
22222222222222222222222222222222222222220001011111011111011111011111010101111111011101011101010111111101110111110002222222222222222222222222222222222222222
22222222222222222222222222222222222222200001010001000100010000010000010100000000010001010101010000000000010000000000222222222222222222222222222222222222222
22222222222222222222222222222222222220000111111101110111011111011111110101111111011111010101111111011101010111011100002222222222222222222222222222222222222
22222222222222222222222222222222222000000100000000010000000001000000000101010001000000000100000001010101010101010100000022222222222222222222222222222222222
22222222222222222222222222222222220001110101110111110111111101111101110111011101110111111111111101010111010101110111110002222222222222222222222222222222222
22222222222222222222222222222222000001000101010101000101000100000101000100000100000101000000000001010000010100000000010000022222222222222222222222222222222
22222222222222222222222222222220011111111101011101011101010101110101011101110101111101111101111111110111011111110111010111002222222222222222222222222222222
22222222222222222222222222222200010000000001000100010001010101000101010000010101000000000101000000000101000001000101010101000222222222222222222222222222222
22222222222222222222222222220001110101111111011101111101011111011101011111010111110111111101011111111101110111011101011101110002222222222222222222222222222
22222222222222222222222222200001000101000000010001000001000000010001000001010000000100010001010000000000010000010001010001010000222222222222222222222222222
22222222222222222222222222000101110101110111011101011111011111110111111101011101111101010111011101111101011111110101010111011100022222222222222222222222222
22222222222222222222222220000100010100010101000101010000010000000100000001000101000001010100000101000101000000000101000100000100002222222222222222222222222
22222222222222222222222200011111111111010101110101011111010111110111111101011101110111010111110101110111110111111101111101110101000222222222222222222222222
22222222222222222222222000010000000000010001000101000001010101010000000101010100010101010000010100010000010100000000000001010101000022222222222222222222222
22222222222222222222220001110111110111011101111101011101110101011111110111110111010101011111010111010111111101111111010111010111010002222222222222222222222
22222222222222222222200000000100010101000100000001010100000101000000010000000000010101010000010001010000000001000101010100010001010000222222222222222222222
22222222222222222222000111011101011101111101111111010111110101011101110111011111110101010111110111011111110111010101011101111101011100022222222222222222222
22222222222222222220000101010001000000010001000000010000010101000101000101010000000100010100000100010000010100010101000001000101010100002222222222222222222
22222222222222222200011101110111110111010111011111011101110101110111011101110111110111110111010111010111010101110101111111011101010101000222222222222222222
22222222222222222000010000000100010101010100000101010101000000010100010000000001010100000001010001010100010101010100000000000001010101000022222222222222222
22222222222222222001110111011101111101010111110101010101111111010111110101111111010111011111011101011101110101010111111111011111010101110022222222222222222
22222222222222220001010101010000000100010000010100010100000001010000000101000100000001010000010101000101010101010000000001010000010101000002222222222222222
22222222222222200111011101011111011101111111010111110111010111011101110111110111110111010111110101011101010101011111011101010111110101111100222222222222222
22222222222222000000000101010001000001000000010100000001010100010101010000010000010100010100000001000001010101000101000101010001000100000100022222222222222
22222222222222011111110101011101111111011111110111111101010111010111011101011111011101110111011101111101010101011101011101011101010111110111022222222222222
22222222222220000100010101000100000000010000000000000001010001000100000101000100000001000001010101000101000101010001010101000101010000010001002222222222222
22222222222200011101010101110101111101110111111111111101011101110111110101111101111111011101010101110101011101010101010101110111011111011111000222222222222
22222222222200010001010000010101000101000100010000000101010000010000010100000001000000010101010100000101010000010101010001000000010001000001000222222222222
22222222222001110111010111110101110101110111011101111101011101110111110111011111011101110111010111011101110111110101110111011111011101111101110022222222222
22222222222000010101010100000100010100010000010101000001000101000000000001010000010100010100010001010001000100000101000101010001000100000100010022222222222
22222222220001110101110101110111110101011111010101011111011101011111110111010111110111110101110101110101011101111111011101011101111111011111010002222222222
22222222200001000100000100010000000101000001000101000100010101010100010100010100000000000101000100000101010001000000010001000100000000010000010000222222222
22222222200111110111011111011111011101110111011101011101110101010101110111111101111111011101110101110111011101011101110111010111011101110111010100222222222
22222222000100010001000001000100010000010100010001010001000101000101000000000001000001000000010101010100000101010101000100010001000101000101010100022222222
22222222010111010111111101011101111111110101110111110111010101111101011111111111011111011111010111011101111101110101110111011101110101111101110111022222222
22222220010100010000000101010001000000000101000000000101010100000001000100000000010000010001010001000001000000000100010001010100010100000000000001002222222
22222220011101110111110101011111110111111101111111110101010111011101111101111111010111110111011101111101110111011101110111010111011111010111111111002222222
22222200000001010100010101000100000100000000000000010001010100010100000001000100010100000100010100000101010001010001000100010100000001010100000100000222222
22222201111111010111010101110101111101111111111111110111011101110101111101110111110111110101110111011101011101011101110101110111011111010111010111110222222
22222201000000000001010100010101000001000100000000000100000001000101000100010000000000010100000001010000000101010000010100000001010000010001010000010222222
22222001011111111101010111110101110101011101111111111111111111110111110111111111111111110111111111011111011101110111110111111111011101111101110101110022222
22222001010000010101010000010000010101010000000001000000000000000000000000000000000000000000000000000001010100000100000000000001000101000100010101000022222
22220001010111010101011101110111110111011111011101022222222222222222222222222222222222222222222222222201110101111101111111011111011101010111110101110002222
22220001010101010001000100010100000000000101010101022222222222222222222222222222222222222222222222222200000101000000010101010000010001010000000100010002222
22220111010101011111010111010101111111110101110101022222222222222222222222222222222222222222222222222201011101111111010101010111010111010111111111011102222
22200001010001000000010001000100010000010100000100022222222222222222222222222222222222222222222222222201010000000001000100010100010100010101000001000100222
22200111011111011111111101111101110111110101110111022222222222222222222222222222222222222222222222222201110111110101110111110101110111011101111101010100222
22200101000001000001000100000001000100000101010001022222222222222222222222222222222222222222222222222201000100010100010001000101000001000000000101010100222
22200101011111011111010111111111011101110111010111022222222222222222222222222222222222222222222222222201011111011111011101011101011101110111110101010100222
22000100010000010000010000000000010001000000010100022222222222222222222222222222222222222222222222222201000001000000000101000101010100010100010101010100022
22010111011101111101011111111111110111011111110111022222222222222222222222222222222222222222222222222201110111011111111101011101110101010111011101110111022
22010101000100000101010000000000000100010000000001022222222222222222222222222222222222222222222222222200010101010100000001010100000101010101000001000001022
22011101011101111101110111111101111101110111111101022222222222222222222222222222222222222222222222222201011101010101111101110111011101110101110111011101022
20000001010001000001000101000101010001000000010101022222222222222222222222222222222222222222222222222201010000010001000100000001010001000000010100010101002
20011111011101011101011101011101011101011111110101022222222222222222222222222222222222222222222222222201110111110111010101111101010111111111110101110111002
20010000000101010001000001010000000101010000000101022222222222222222222222222222222222222222222222222201000100010100010101000100010001000000000101000001002
20011101111101011101110111010111110101010111111101022222222222222222222222222222222222222222222222222201010101010111010111010111011101011111011101011101002
20000101000001000100010100010100010101010000000001022222222222222222222222222222222222222222222222222201010101010001010000010001000101010001000001010001002
20011101110111110111010111011101010101010111111111022222222222222222222222222222222222222222222222222201110101111101110101111101011101010101111111011111002
20010000010000010001010101000001010101010100000001022222222222222222222222222222222222222222222222222200010101000000010101000101010001010100000000010000002
00011111010111110111010101011101110101110111110111022222222222222222222222222222222222222222222222222201010101011111110111110101010111010101110111110111000
00010001010100000100010101010001000100010000010100022222222222222222222222222222222222222222222222222201010101010000000000000101010000010101010100000100000
01110111011101110111010101011101110111010111110101022222222222222222222222222222222222222222222222222201110101010111111111111101011111010111010111110111110
01000100000001010101010001010100010100010100000101022222222222222222222222222222222222222222222222222200000101010000000100000001000001010100010000010001000
01010111111101011101110111010111011101110101110101022222222222222222222222222222222222222222222222222201111101011111110111111101111111010111011111011101110
01010000000101000000000100010001000101000101010101022222222222222222222222222222222222222222222222222201000001000000010000000100000000010000000101000100010
01111111110101011111110101110101011101010101010101022222222222222222222222222222222222222222222222222201110101011111011111111101111111110111110101110111110
01000000000101000001010100010101010001010101000101022222222222222222222222222222222222222222222222222201010101000001000000000101000000010100010101000000010
01011111011101111111010111011101010111110101111111022222222222222222222222222222222222222222222222222201010111111111011101111101110101110101111101011111010
00010001010100000000010101000101010100000101000000022222222222222222222222222222222222222222222222222201010000000001000101000000010101000100000000010100010
01110101110101111111010101011101110111011101110111022222222222222222222222222222222222222222222222222201011101111101011101110111010101011111111111110111110
01000101000001000101010101000001000001010000000101022222222222222222222222222222222222222222222222222201000100000101010000010101010101010000000000000000010
01110111011111011101010101111101011111011111111101022222222222222222222222222222222222222222222222222201011101111101011101110101111101010111110111111111010
01010000010000010001010000010100010000000000010001022222222222222222222222222222222222222222222222222200010001000001000101000100000001010000010100000001010
01011101110101110111010111010111110101111111010111022222222222222222222222222222222222222222222222222201110111111101110101110101110111011111110101110111010
00010101000101000100010101000100000101000001000101022222222222222222222222222222222222222222222222222201000000010100010100010100010100000000000101010101000
00010111111101110101011101110111111101110101111101022222222222222222222222222222222222222222222222222201011111010111011101110111010111111111111111010101000
20010000000000010101000000010000010000010101000000022222222222222222222222222222222222222222222222222201010001010001000101000001010000000000000000000101002
20010111111111010111011111011111010111110111011111022222222222222222222222222222222222222222222222222201011101011101110101111101110111111111111101110101002
20000100000001010001010001000001010100010000010001022222222222222222222222222222222222222222222222222201000101000000010100000100000100000000000101010101002
20011101111101110111010101111101010111010111011101022222222222222222222222222222222222222222222222222201111101111111011111010111111101110101110101011101002
20010001000100000100010100000101010001000101010001022222222222222222222222222222222222222222222222222200000100000001000001010000000001010101010101000001002
20010111110101111101110111110111011101111101110111022222222222222222222222222222222222222222222222222201110101111101110111011111111111011101011101011111002
20010000010101000001000001000000000000000000010100022222222222222222222222222222222222222222222222222201010001000101010100010100000000000101000001000001002
22011101110111011101011101111111111111111111010111022222222222222222222222222222222222222222222222222201011111010101010111010101111101111101110111111101022
22010101000000010101010100000101000000000001010001022222222222222222222222222222222222222222222222222201000000010100010001010001000101000000010100000101022
22010101110111110101010111110101011101111111010111022222222222222222222222222222222222222222222222222201110101111101110111011111010101011111110111011101022
22000100010001000001010000010001000101000000010101022222222222222222222222222222222222222222222222222201010101000001000100010000010100010000000001010000022
22200101011101111101010111011101011101111101110101022222222222222222222222222222222222222222222222222201010111011111011101111111110111010111110111011100222
22200101000101000101010001000101010100000101000101022222222222222222222222222222222222222222222222222200010100000100010000000100000001010100010100000100222
22200101110101110101011101110111010101110101011101022222222222222222222222222222222222222222222222222201110111110111011111011101111101010111011101111100222
22200100010100010101010101010000010001010101010000022222222222222222222222222222222222222222222222222201000000010001000001000001000101010001000001000100222
22220111011101110101010101011101111111011101011111022222222222222222222222222222222222222222222222222201011101110111011101111111011111011101011111011102222
22220001010001000101000101000101000000000000000001000000000000000000000000000000000000000000000000000001010001000100010000000001000000000101010000010002222
22220001011101110101110101110111011111111111011101010111110111111111011101111101111111011111011111011111011101111101111111111111011111111101011101010002222
22222001000100000100010100010000000100000001010101010101000100010100010101000101000100010001010101000001010100000001000000000000010000000000000101010022222
22222001011111110111010111010111111101111101110111010101111101010101110101011101010111111101110101111111010111111101011111111111010111011111111101110022222
22222201000000010100010001010100010001000100000000010100000001010001000101010101010000000000000100000000000000000101010001010000010101000100000001000222222
22222201110111110111011111010111010111110111111101111101111111011101110101010101110111110111111101111111111111110101011101010111110101111101111101110222222
22222200010001000001000000010000010000000001000001000000010000000100010101010000010100010100000001000100010000010101000001000100000100000000000101000222222
22222220011101111111011111011111010111111101111101111111011111110111110111011111010101011101110111110101110111011101011111011101111101111111111101002222222
22222220010100000001010001000001010100000100000100000001000000010000000000000001010101010001010100000100000101000001010001010001000001000000000001002222222
22222222010111110101011101110111011111110101111111011101011111111101110111011101110101110111010101110101111101111111010111010111110111110111110111022222222
22222222000100010101010100000100010000000101000000010101010000000101010101010100000100000100010001010101000000000001010100010000010100010100010100022222222
22222222200111010101010101111101110101111101011111110111010111111101011101110111110111110101010111010101110111111101110111011101110111010111011100222222222
22222222200000010101000101000001000101000001010000000000010000010000000000010001000000010101010100010101000100000100010000000101000000010001000000222222222
22222222220001110111111101011101011101110101110111110111111111011101111111011101011111010111011101110111011111110101110111110111011111010111010002222222222
22222222222001000000010001010101010100010101000000010100000001000101000001000001010001010001000001000100010000000101000101000000010001010100010022222222222
22222222222001111111010111010101010101110101011111011101111111010111011101111101010111111101111101110101110111110101011101111111011101110101110022222222222
22222222222200010001000100000101010101000101000101000001000000010000000100000101010000010001000000010101000100010100010000000101000100010101000222222222222
22222222222200010101111101110111010101011101011101111101111101111111111111110111011101110111011111110101110101010101110111111101111101110111000222222222222
22222222222220010100000001010100000101000101010000000101000100000100010000000001000101000100010000000101000101010101000100010000000000000001002222222222222
22222222222222011101111111010101111101011101110111110101110101110111011111111101010101011101011111110101011101010111011101010111111111111111022222222222222
22222222222222000101000000010101000101010000000100010100000101010001000000000101010101010001000000010101010001010000010001010100000000000000022222222222222
22222222222222200111011101110111010101011111110111011101111101010101011101111101110101011111011111010101010111111101110111110111011111111100222222222222222
22222222222222220000010101000000010101010100010001000001010001010101010101000000010101000001000101010001010000000101000100000001000001010002222222222222222
22222222222222222001110101011111011101010101110101110111010111010111110101110111110101011111011101011111011111110111011101111101111111010022222222222222222
22222222222222222000010101000101000001000101000100010100000100010000000001010100000100010000010001000000000000010000010001010000000001000022222222222222222
22222222222222222200010101011101111111011101011111010111111101011111111101010101110111010111110111110111011111011101110111011111111111000222222222222222222
22222222222222222220000101010000000000010001000001010100000001000000000100010101000001010001000000010100010001000100000100000000000000002222222222222222222
22222222222222222222000111110111110111110101011111010101111111011111110111011111011111011101111111010111111101110111011101110111111100022222222222222222222
22222222222222222222200000000001010000010101010100010101000001010000010001000000010001000101000001010000000000010001010001010101010000222222222222222222222
22222222222222222222220001111111011111110111110101110101011101010111111101011111011101011101111101010111011111011101011101010101010002222222222222222222222
22222222222222222222222000010000000100000000000101000101010101010100000001010001000101010000000001010101010001000101000101010001000022222222222222222222222
22222222222222222222222200011101111101111111011101010101010101110111011101011101011101010111011101010101110111111101110111010111000222222222222222222222222
22222222222222222222222220000100000101000001000001010101010100000100010101000101010001010101010101010100000000000001010000010100002222222222222222222222222
22222222222222222222222222000111110101011101011111010111010101111101110111110101011101011101110101010111110111111101011111011100022222222222222222222222222
22222222222222222222222222200001010001000101010000010001010101000001010000000101000100000000000101010000010100000101000000010000222222222222222222222222222
22222222222222222222222222220001011101111101110111010111010101110101010111110101110111111111110101011111010101011101011111110002222222222222222222222222222
22222222222222222222222222222200010100000100000101010100010100010101000100010101000000000000010101000001010101010101010000000222222222222222222222222222222
22222222222222222222222222222220010111110111011101011101110111011101011101011101011101111111011101111101110101010101011111002222222222222222222222222222222
22222222222222222222222222222222000001000001010001000001000001010001010001000001010101010001000000000100000101010101010000022222222222222222222222222222222
22222222222222222222222222222222220001111101110101111101110111010111011111011101110101011101011101110111011101010101110002222222222222222222222222222222222
22222222222222222222222222222222222000000100000100000101010100000101000001000100000101000101010101010001010001010100000022222222222222222222222222222222222
22222222222222222222222222222222222220000111110111110101010101111101011111110111110111011101010101011101111111010100002222222222222222222222222222222222222
22222222222222222222222222222222222222200001010101000100010101010000010000010100000100010001010101000101000000010000222222222222222222222222222222222222222
22222222222222222222222222222222222222220001011101111101110101011111110111011101110111010111010101110101110111110002222222222222222222222222222222222222222
22222222222222222222222222222222222222222200000100000001000101000000000101000001010001010100010101010100000100000222222222222222222222222222222222222222222
22222222222222222222222222222222222222222222000111111101010101110111111101011111011101010111110101010111111100022222222222222222222222222222222222222222222
22222222222222222222222222222222222222222222220000000101010100000100000001010000000100010000000100010100000002222222222222222222222222222222222222222222222
22222222222222222222222222222222222222222222222220000111011111111101111101110111110111110111110111110100002222222222222222222222222222222222222222222222222
22222222222222222222222222222222222222222222222222200000000000000001010000000101000000000101000100000000222222222222222222222222222222222222222222222222222
22222222222222222222222222222222222222222222222222222200000111111111011111110101011111111101111100000222222222222222222222222222222222222222222222222222222
22222222222222222222222222222222222222222222222222222222220000000000000101000101010000000000000002222222222222222222222222222222222222222222222222222222222
22222222222222222222222222222222222222222222222222222222222222000000000101111101111100000000022222222222222222222222222222222222222222222222222222222222222
22222222222222222222222222222222222222222222222222222222222222222222200000000000000000222222222222222222222222222222222222222222222222222222222222222222222
